NO     ./textures/bluestone.xpm

SO         ./textures/wall_1.xpm

WE   ./textures/sky_1.xpm
EA ./textures/purplestone.xpm

F 3,16,17
C 20,31,35

        1111111111111111111111111
        1000000000110000000000001
        1011000001110000000000001111
        100100000000S000000000001
111111111011000001110000000000001111
11000000001100000111011111111111111
01110111111111011100000010001
111101111111110111010100000001
110000001101010111000000100010
10000000000000001100000010001
10000000000000001101010010001
1100000111010101111101111000111
11110111 1110101 101111010001
11111111 1111111 111111111111