F 111,111,111



C 30,30,30

NO    ./textures/wall_test4.xpm


SO         ./textures/wall_test2.xpm

WE   ./textures/wall_test.xpm
EA ./textures/wall_test3.xpm

111111111111111111111
100000000000000000001
100000000001000000001
100000N00011000000001
100000000110000000001
110000000110000000001
111000111111100000111
100000011100000000011
1000000111000000001
1111100111111110001
1000000000000000001
1000000000000000001
1000000000000000001
1111111111111111111
